%%%%%%%%%%%%%%%%%%%%%%%%%%%%%%%
%P..%.........%.%..%......%..G%
%...|.....%...|.%..|......|...%
%...%.....%...%.%..%......%...%
%%|%%%%%%%%%|%%.%..%%%%%|%%%|%%
%.......%.....%.|..%......%...%
%.......%.....%.%..%......%...%
%.......%.....%.%..%%%|%%%%...%
%%%%%%|%%%%%%%%.%..%......%...%
%...%.........%.%..%......%...%
%...|.........|.|..|......|...%
%...%.........%.%..%......%...%
%%|%%%%%%%|%%%%.%%%%%%|%%%%%|%%
%.............................%
%%|%%%%%%%%%%%%.%%%%%%%%%%%%%%%
%.....%.......%.%...%...%.....%
%.....|.......|.%...|...|.....%
%|%%%%%%%%%%%%%.%%%%%...%%%%%%%
%.....%.......%.|.......%.....%
%.....%.......%.%.......|.....%
%.....%.......%.%%%|%%%|%%%%%%%
%.....|.......%.%.....%.......%
%%|%%%%%%%%|%%%.|.....%%%|%...%
%...|..%..|...%.%.....|...%...%
%...%..%..%...|.%.....%...%...%
%...%.....%...%.%.....%...%...%
%%%%%%%%%%%%%%%%%%%%%%%%%%%%%%%
