%%%%%%%%%%%%%%%
%aaa%bbbbb|ccc%
%aaa|bbbbb%ccc%
%aaa%bbbbb%ccc%
%%|%%%%%%%%%|%%
%ddddddd%eeeee%
%ddddddd%eeeee%
%ddddddd%eeeee%
%%%%%%|%%%%%%|%
%fff%ggggggggg%
%fff|ggggggggg%
%fff%ggggggggg%
%%%%%%%%%%%%%%%