%%%%%%%%%%%%%%%
%P..%.....|...%
%...|.....%...%
%...%.....%...%
%%|%%%%%%%%%|%%
%.......%.....%
%.......%.....%
%.......%.....%
%%%%%%|%%%%%%|%
%...%.........%
%...|.........%
%...%........G%
%%%%%%%%%%%%%%%