%%%%%%%%%%%%%%%
%P..%.....|...%
%...|.....%...%
%...%.....%...%
%%|%%%%%%%%%|%%
%.......%.....%
%.......%.....%
%.......%.....%
%%%%%%|%%%%%%|%
%...%.........%
%...|.........%
%...%.......G.%
%%%%%%%%%%%%%%%