%%%%%%%
%Paaaa%
%aaaaa%
%aaaaG%
%%%%%%%