%%%%%%%
%P....%
%.....%
%....G%
%%%%%%%