%%%%%%%%%%%%%
%.....%.....%
%.....%.....%
%..P..|..G..%
%.....%.....%
%.....%.....%
%%%%%%%%%%%%%