%%%%%%%%%%%%%
%aaaaa%bbbbb%
%aaaaa%bbbbb%
%aaaaa|bbbbb%
%aaaaa%bbbbb%
%aaaaa%bbbbb%
%%%%%%%%%%%%%